22
          *                            *
  *************    **************    **************
         *               *                 *
         *               *                 *
         *               *                 *
         *               *                 *
         *               *                 *
               
         *               *                 *
         *               *                 *
         *               *                 *
                                                                                  
                                                         
               *                   *
               *                   *
               *                   *
                                  
               *                   *
               *                   *
               *                   *
               *                   *       
  *********************     ************************