22
**************************************************
*                                                *
*                                                *
*                        *                       *
*                         *                      *
*                          *                     *
*        *                  *                    *
*         *                  *                   *
*          *                  *                  *
*           *                  *                 *
*            *                  *                
*             *                  *               
*              *                  *              *
*               *                  *             *
*                *                  *            *
*                 *                  *           *
*                  *                  *          *
*                   *                            *
*                    *                           *
*                     *                          *
*                                                *
**************************************************